Абхазии - Сухуми
Австралии - Канберра
Австрии - Вена
Азербайджана - Баку
Албании - Тирана
Алжира - Алжир
Анголы - Луанда
Андорры - Андорра-ла-Велья
Аргентины - Буэнос-Айрес
Армении - Ереван
Афганистана - Кабул
Бангладеша - Дакка
Барбадоса - Бриджтаун
Бахрейна - Манама
Белиза - Бельмопан
Беларуси - Минск
Бельгии - Брюссель
Бенина - Порто-Ново
Болгарии - София
Боливии - Ла-Пас
Ботсваны - Габороне
Бразилии - Бразилиа
Брунея - Бандар-Сери-Бегаван
Буркина-Фасо - Уагадугу
Бурунди - Бужумбура
Бутана - Тхимпху
Вануату - Вила
Ватикана - Ватикан
Великобритании - Лондон
Венгрии - Будапешт
Венесуэлы - Каракас
Вьетнама - Ханой
Габона - Либревиль
Гаити - Порт-о-Пренс
Гайаны - Джорджтаун
Гамбии - Банжул
Ганы - Аккра
Гватемалы - Гватемала
Гвинеи - Конакри
Германии - Берлин
Гондураса - Тегусигальпа
Гренады - Сент-Джорджес
Греции - Афины
Грузии - Тбилиси
Дании - Копенгаген
Джибути - Джибути
Доминики - Розо
Доминиканы - Санто-Доминго
Египта - Каир
Замбии - Лусака
Зимбабве - Хараре
Израиля - Иерусалим
Индии - Нью-Дели
Индонезии - Джакарта
Иордании - Амман
Ирака - Багдад
Ирана - Тегеран
Ирландии - Дублин
Исландии - Рейкьявик
Испании - Мадрид
Италии - Рим
Йемена - Сана
Кабо-Верде - Прая
Казахстана - Астана
Камбоджи - Пномпень
Камеруна - Яунде
Канады - Оттава
Катара - Доха
Кении - Найроби
Кипра - Никоcия
Киргизии - Бишкек
Кирибати - Тарава
Китая - Пекин
Колумбии - Богота
Конго - Браззавиль
Косово - Приштина
Коста-Рика - Сан-Хосе
Кубы - Гавана
Кувейта - Эль-Кувейт
Кыргызстана - Бишкек
Лаоса - Вьентьян
Латвии - Рига
Лесото - Масеру
Либерии - Монровия
Ливана - Бейрут
Ливии - Триполи
Литвы - Вильнюс
Лихтенштейна - Вадуц
Люксембурга - Люксембург
Мавритании - Нуакшот
Мадагаскара - Антананариву
Македонии - Скопье
Малави - Лилонгве
Малайзии - Куала-Лумпур
Мали - Бамако
Мальдив - Мале
Мальты - Валетта
Марокко - Рабат
Мексики - Мехико
Микронезии - Паликир
Мозамбика - Мапуту
Молдовы - Кишинев
Монако - Монако
Монголии - Улан-Батор
Мьянмы - Янгон
Намибии - Виндхук
Науру - Ярен
Непала - Катманду
Нигера - Ниамей
Нигерии - Абуджа
Нидерланд - Амстердам
Никарагуа - Манагуа
Норвегии - Осло
ОАЭ - Абу-Даби
Омана - Маскат
Пакистана - Исламабад
Палау - Корор
Панама - Панама
Парагвая - Асунсьон
Перу - Лима
Польши - Варшава
Португалии - Лиссабон
Пуэрто-Рико - Сан-Хуан
России - Москва
Руанды - Кигали
Румынии - Бухарест
Сальвадора - Сан-Сальвадор
Самоа - Апиа
Сан-Марино - Сан-Марино
Свазиленда - Мбабане
Сенегала - Дакар
Сент-Люсии - Кастри
Сербии - Белград
Сингапура - Сингапур
Сирии - Дамаск
Словакии - Братислава
Словении - Любляна
Сомали - Могадишо
Судана - Хаpтум
Суринама - Паpамаpибо
США - Вашингтон
Сьерра-Леоне - Фpитаун
Таджикистана - Душанбе
Таиланда - Бангкок
Тайваня - Тайпей
Танзании - Додома
Того - Ломе
Тонго - Нукуалофа
Тувалу - Фунафути
Туниса - Тунис
Туркменистана - Ашхабад
Турции - Анкаpа
Уганда - Кампала
Узбекистана - Ташкент
Украины - Киев
Уругвая - Монтевидео
Фиджи - Сува
Филиппин - Манила
Финляндии - Хельсинки
Франции - Париж
Хорватии - Загреб
ЦАР - Банги
Чада - Нджамена
Черногории - Цетине
Чехии - Прага
Чили - Сантьяго
Швейцарии - Берн
Швеции - Стокгольм
Шри-Ланки - Коломбо
Эквадора - Кито
Эритреи - Асмэра
Эстонии - Таллинн
Эфиопии - Аддис-Абеба
ЮАР - Претория
Ямайки - Кингстон
Японии - Токио